
1111111
1P0C0E1
100C001
1111111