1111111111111

1P0C000C00E01
1111111111111