111111111111111111111111111111
1E0000000000CCCC0000X000000001
100X000000111000000011111111P1
100000001110000000111000011101
100000111011100000000001110001
10001110011100CCC0001110000001
101111111111100001110000000001
100000011100000111000000000001
100000011100011111111000000001
1C0000000000000000000000000001
111111111111111111111111111111